                Airlift - Description of internal state
  PT    HT   P00   P01   P02   P03   P04   P05   P06   P07   P08   P09   P10   P11   P12   P13   P14   P15   P16   P17   P18   P19   P20   InQ  InF  PTAL  Entity
 ATRG  WTFL  GTAP  GTAP  GTAP  GTAP  GTAP  GTAP  GTAP  GTAP  GTAP  GTAP  GTAP  GTAP  GTAP  GTAP  GTAP  GTAP  GTAP  GTAP  GTAP  GTAP  GTAP   0    0    0	   header

 Flight 1: boarding started
 RDFB  WTFL  GTAP  GTAP  GTAP  GTAP  GTAP  GTAP  GTAP  GTAP  GTAP  GTAP  GTAP  GTAP  GTAP  GTAP  GTAP  GTAP  GTAP  GTAP  GTAP  GTAP  GTAP   0    0    0	   pilot
 WTFB  WTFL  GTAP  GTAP  GTAP  GTAP  GTAP  GTAP  GTAP  GTAP  GTAP  GTAP  GTAP  GTAP  GTAP  GTAP  GTAP  GTAP  GTAP  GTAP  GTAP  GTAP  GTAP   0    0    0	   pilot
 WTFB  WTPS  GTAP  GTAP  GTAP  GTAP  GTAP  GTAP  GTAP  GTAP  GTAP  GTAP  GTAP  GTAP  GTAP  GTAP  GTAP  GTAP  GTAP  GTAP  GTAP  GTAP  GTAP   0    0    0	   hostess
 WTFB  WTPS  GTAP  GTAP  GTAP  GTAP  GTAP  GTAP  GTAP  GTAP  GTAP  GTAP  GTAP  GTAP  GTAP  GTAP  GTAP  GTAP  GTAP  GTAP  GTAP  GTAP  GTAP   0    0    0	   hostess
 WTFB  WTPS  GTAP  GTAP  GTAP  GTAP  INQE  GTAP  GTAP  GTAP  GTAP  GTAP  GTAP  GTAP  GTAP  GTAP  GTAP  GTAP  GTAP  GTAP  GTAP  GTAP  GTAP   1    0    0	   passenger

 Flight 1: passenger 4 checked
 WTFB  CKPS  GTAP  GTAP  GTAP  GTAP  INQE  GTAP  GTAP  GTAP  GTAP  GTAP  GTAP  GTAP  GTAP  GTAP  GTAP  GTAP  GTAP  GTAP  GTAP  GTAP  GTAP   0    0    0	   hostess
 WTFB  CKPS  INQE  GTAP  GTAP  GTAP  INQE  GTAP  GTAP  GTAP  GTAP  GTAP  GTAP  GTAP  GTAP  GTAP  GTAP  GTAP  GTAP  GTAP  GTAP  GTAP  GTAP   1    0    0	   passenger
 WTFB  CKPS  INQE  GTAP  INQE  GTAP  INQE  GTAP  GTAP  GTAP  GTAP  GTAP  GTAP  GTAP  GTAP  GTAP  GTAP  GTAP  GTAP  GTAP  GTAP  GTAP  GTAP   2    0    0	   passenger
 WTFB  CKPS  INQE  INQE  INQE  GTAP  INQE  GTAP  GTAP  GTAP  GTAP  GTAP  GTAP  GTAP  GTAP  GTAP  GTAP  GTAP  GTAP  GTAP  GTAP  GTAP  GTAP   3    0    0	   passenger
 WTFB  CKPS  INQE  INQE  INQE  INQE  INQE  GTAP  GTAP  GTAP  GTAP  GTAP  GTAP  GTAP  GTAP  GTAP  GTAP  GTAP  GTAP  GTAP  GTAP  GTAP  GTAP   4    0    0	   passenger
 WTFB  WTPS  INQE  INQE  INQE  INQE  INQE  GTAP  GTAP  GTAP  GTAP  GTAP  GTAP  GTAP  GTAP  GTAP  GTAP  GTAP  GTAP  GTAP  GTAP  GTAP  GTAP   4    0    0	   hostess

 Flight 1: passenger 0 checked
 WTFB  CKPS  INQE  INQE  INQE  INQE  INQE  GTAP  GTAP  GTAP  GTAP  GTAP  GTAP  GTAP  GTAP  GTAP  GTAP  GTAP  GTAP  GTAP  GTAP  GTAP  GTAP   3    0    0	   hostess
 WTFB  WTPS  INQE  INQE  INQE  INQE  INQE  GTAP  GTAP  GTAP  GTAP  GTAP  GTAP  GTAP  GTAP  GTAP  GTAP  GTAP  GTAP  GTAP  GTAP  GTAP  GTAP   3    0    0	   hostess

 Flight 1: passenger 2 checked
 WTFB  CKPS  INQE  INQE  INQE  INQE  INQE  GTAP  GTAP  GTAP  GTAP  GTAP  GTAP  GTAP  GTAP  GTAP  GTAP  GTAP  GTAP  GTAP  GTAP  GTAP  GTAP   2    0    0	   hostess
 WTFB  WTPS  INQE  INQE  INQE  INQE  INQE  GTAP  GTAP  GTAP  GTAP  GTAP  GTAP  GTAP  GTAP  GTAP  GTAP  GTAP  GTAP  GTAP  GTAP  GTAP  GTAP   2    0    0	   hostess

 Flight 1: passenger 1 checked
 WTFB  CKPS  INQE  INQE  INQE  INQE  INQE  GTAP  GTAP  GTAP  GTAP  GTAP  GTAP  GTAP  GTAP  GTAP  GTAP  GTAP  GTAP  GTAP  GTAP  GTAP  GTAP   1    0    0	   hostess
 WTFB  WTPS  INQE  INQE  INQE  INQE  INQE  GTAP  GTAP  GTAP  GTAP  GTAP  GTAP  GTAP  GTAP  GTAP  GTAP  GTAP  GTAP  GTAP  GTAP  GTAP  GTAP   1    0    0	   hostess

 Flight 1: passenger 3 checked
 WTFB  CKPS  INQE  INQE  INQE  INQE  INQE  GTAP  GTAP  GTAP  GTAP  GTAP  GTAP  GTAP  GTAP  GTAP  GTAP  GTAP  GTAP  GTAP  GTAP  GTAP  GTAP   0    0    0	   hostess
 WTFB  WTPS  INQE  INQE  INQE  INQE  INQE  GTAP  GTAP  GTAP  GTAP  GTAP  GTAP  GTAP  GTAP  GTAP  GTAP  GTAP  GTAP  GTAP  GTAP  GTAP  GTAP   0    0    0	   hostess
 WTFB  WTPS  INFL  INQE  INQE  INQE  INQE  GTAP  GTAP  GTAP  GTAP  GTAP  GTAP  GTAP  GTAP  GTAP  GTAP  GTAP  GTAP  GTAP  GTAP  GTAP  GTAP   0    1    0	   passenger
 WTFB  RDTF  INFL  INQE  INQE  INQE  INQE  GTAP  GTAP  GTAP  GTAP  GTAP  GTAP  GTAP  GTAP  GTAP  GTAP  GTAP  GTAP  GTAP  GTAP  GTAP  GTAP   0    1    0	   hostess
 WTFB  WTFL  INFL  INQE  INQE  INQE  INQE  GTAP  GTAP  GTAP  GTAP  GTAP  GTAP  GTAP  GTAP  GTAP  GTAP  GTAP  GTAP  GTAP  GTAP  GTAP  GTAP   0    1    0	   hostess

 Flight 1: departed with 5 passengers
 FLFW  WTFL  INFL  INQE  INQE  INQE  INQE  GTAP  GTAP  GTAP  GTAP  GTAP  GTAP  GTAP  GTAP  GTAP  GTAP  GTAP  GTAP  GTAP  GTAP  GTAP  GTAP   0    1    0	   pilot

 Flight 1: departed with 5 passengers
 FLFW  WTFL  INFL  INQE  INQE  INFL  INQE  GTAP  GTAP  GTAP  GTAP  GTAP  GTAP  GTAP  GTAP  GTAP  GTAP  GTAP  GTAP  GTAP  GTAP  GTAP  GTAP   0    2    0	   passenger

 Flight 1: departed with 5 passengers
 FLFW  WTFL  INFL  INFL  INQE  INFL  INQE  GTAP  GTAP  GTAP  GTAP  GTAP  GTAP  GTAP  GTAP  GTAP  GTAP  GTAP  GTAP  GTAP  GTAP  GTAP  GTAP   0    3    0	   passenger

 Flight 1: departed with 5 passengers
 FLFW  WTFL  INFL  INFL  INQE  INFL  INFL  GTAP  GTAP  GTAP  GTAP  GTAP  GTAP  GTAP  GTAP  GTAP  GTAP  GTAP  GTAP  GTAP  GTAP  GTAP  GTAP   0    4    0	   passenger

 Flight 1: departed with 5 passengers
 FLFW  WTFL  INFL  INFL  INFL  INFL  INFL  GTAP  GTAP  GTAP  GTAP  GTAP  GTAP  GTAP  GTAP  GTAP  GTAP  GTAP  GTAP  GTAP  GTAP  GTAP  GTAP   0    5    0	   passenger

 Flight 1: departed with 5 passengers
 FLFW  WTFL  INFL  INFL  INFL  INFL  INFL  GTAP  GTAP  GTAP  INQE  GTAP  GTAP  GTAP  GTAP  GTAP  GTAP  GTAP  GTAP  GTAP  GTAP  GTAP  GTAP   1    5    0	   passenger

 Flight 1: departed with 5 passengers
 FLFW  WTFL  INFL  INFL  INFL  INFL  INFL  GTAP  GTAP  GTAP  INQE  INQE  GTAP  GTAP  GTAP  GTAP  GTAP  GTAP  GTAP  GTAP  GTAP  GTAP  GTAP   2    5    0	   passenger

 Flight 1: flight arrived
 DRPP  WTFL  INFL  INFL  INFL  INFL  INFL  GTAP  GTAP  GTAP  INQE  INQE  GTAP  GTAP  GTAP  GTAP  GTAP  GTAP  GTAP  GTAP  GTAP  GTAP  GTAP   2    5    0	   pilot
 DRPP  WTFL  INFL  INFL  INFL  INFL  INFL  GTAP  GTAP  INQE  INQE  INQE  GTAP  GTAP  GTAP  GTAP  GTAP  GTAP  GTAP  GTAP  GTAP  GTAP  GTAP   3    5    0	   passenger
 DRPP  WTFL  INFL  INFL  INFL  INFL  INFL  GTAP  INQE  INQE  INQE  INQE  GTAP  GTAP  GTAP  GTAP  GTAP  GTAP  GTAP  GTAP  GTAP  GTAP  GTAP   4    5    0	   passenger
 DRPP  WTFL  INFL  INFL  INFL  INFL  INFL  INQE  INQE  INQE  INQE  INQE  GTAP  GTAP  GTAP  GTAP  GTAP  GTAP  GTAP  GTAP  GTAP  GTAP  GTAP   5    5    0	   passenger
 DRPP  WTFL  INFL  ATDS  INFL  INFL  INFL  INQE  INQE  INQE  INQE  INQE  GTAP  GTAP  GTAP  GTAP  GTAP  GTAP  GTAP  GTAP  GTAP  GTAP  GTAP   5    4    1	   passenger
 DRPP  WTFL  INFL  ATDS  ATDS  INFL  INFL  INQE  INQE  INQE  INQE  INQE  GTAP  GTAP  GTAP  GTAP  GTAP  GTAP  GTAP  GTAP  GTAP  GTAP  GTAP   5    3    2	   passenger
 DRPP  WTFL  INFL  ATDS  ATDS  ATDS  INFL  INQE  INQE  INQE  INQE  INQE  GTAP  GTAP  GTAP  GTAP  GTAP  GTAP  GTAP  GTAP  GTAP  GTAP  GTAP   5    2    3	   passenger
 DRPP  WTFL  ATDS  ATDS  ATDS  ATDS  INFL  INQE  INQE  INQE  INQE  INQE  GTAP  GTAP  GTAP  GTAP  GTAP  GTAP  GTAP  GTAP  GTAP  GTAP  GTAP   5    1    4	   passenger
 DRPP  WTFL  ATDS  ATDS  ATDS  ATDS  ATDS  INQE  INQE  INQE  INQE  INQE  GTAP  GTAP  GTAP  GTAP  GTAP  GTAP  GTAP  GTAP  GTAP  GTAP  GTAP   5    0    5	   passenger

 Flight 1: returning
 FLBK  WTFL  ATDS  ATDS  ATDS  ATDS  ATDS  INQE  INQE  INQE  INQE  INQE  GTAP  GTAP  GTAP  GTAP  GTAP  GTAP  GTAP  GTAP  GTAP  GTAP  GTAP   5    0    5	   pilot
 ATRG  WTFL  ATDS  ATDS  ATDS  ATDS  ATDS  INQE  INQE  INQE  INQE  INQE  GTAP  GTAP  GTAP  GTAP  GTAP  GTAP  GTAP  GTAP  GTAP  GTAP  GTAP   5    0    5	   pilot

 Flight 2: boarding started
 RDFB  WTFL  ATDS  ATDS  ATDS  ATDS  ATDS  INQE  INQE  INQE  INQE  INQE  GTAP  GTAP  GTAP  GTAP  GTAP  GTAP  GTAP  GTAP  GTAP  GTAP  GTAP   5    0    5	   pilot
 WTFB  WTFL  ATDS  ATDS  ATDS  ATDS  ATDS  INQE  INQE  INQE  INQE  INQE  GTAP  GTAP  GTAP  GTAP  GTAP  GTAP  GTAP  GTAP  GTAP  GTAP  GTAP   5    0    5	   pilot
 WTFB  WTPS  ATDS  ATDS  ATDS  ATDS  ATDS  INQE  INQE  INQE  INQE  INQE  GTAP  GTAP  GTAP  GTAP  GTAP  GTAP  GTAP  GTAP  GTAP  GTAP  GTAP   5    0    5	   hostess
 WTFB  WTPS  ATDS  ATDS  ATDS  ATDS  ATDS  INQE  INQE  INQE  INQE  INQE  GTAP  GTAP  GTAP  GTAP  GTAP  GTAP  GTAP  GTAP  GTAP  GTAP  GTAP   5    0    5	   hostess

 Flight 2: passenger 8 checked
 WTFB  CKPS  ATDS  ATDS  ATDS  ATDS  ATDS  INQE  INQE  INQE  INQE  INQE  GTAP  GTAP  GTAP  GTAP  GTAP  GTAP  GTAP  GTAP  GTAP  GTAP  GTAP   4    0    5	   hostess
 WTFB  CKPS  ATDS  ATDS  ATDS  ATDS  ATDS  INQE  INQE  INQE  INFL  INQE  GTAP  GTAP  GTAP  GTAP  GTAP  GTAP  GTAP  GTAP  GTAP  GTAP  GTAP   4    1    5	   passenger
 WTFB  WTPS  ATDS  ATDS  ATDS  ATDS  ATDS  INQE  INQE  INQE  INFL  INQE  GTAP  GTAP  GTAP  GTAP  GTAP  GTAP  GTAP  GTAP  GTAP  GTAP  GTAP   4    1    5	   hostess

 Flight 2: passenger 9 checked
 WTFB  CKPS  ATDS  ATDS  ATDS  ATDS  ATDS  INQE  INQE  INQE  INFL  INQE  GTAP  GTAP  GTAP  GTAP  GTAP  GTAP  GTAP  GTAP  GTAP  GTAP  GTAP   3    1    5	   hostess
 WTFB  WTPS  ATDS  ATDS  ATDS  ATDS  ATDS  INQE  INQE  INQE  INFL  INQE  GTAP  GTAP  GTAP  GTAP  GTAP  GTAP  GTAP  GTAP  GTAP  GTAP  GTAP   3    1    5	   hostess
 WTFB  WTPS  ATDS  ATDS  ATDS  ATDS  ATDS  INQE  INQE  INQE  INFL  INFL  GTAP  GTAP  GTAP  GTAP  GTAP  GTAP  GTAP  GTAP  GTAP  GTAP  GTAP   3    2    5	   passenger

 Flight 2: passenger 7 checked
 WTFB  CKPS  ATDS  ATDS  ATDS  ATDS  ATDS  INQE  INQE  INQE  INFL  INFL  GTAP  GTAP  GTAP  GTAP  GTAP  GTAP  GTAP  GTAP  GTAP  GTAP  GTAP   2    2    5	   hostess
 WTFB  WTPS  ATDS  ATDS  ATDS  ATDS  ATDS  INQE  INQE  INQE  INFL  INFL  GTAP  GTAP  GTAP  GTAP  GTAP  GTAP  GTAP  GTAP  GTAP  GTAP  GTAP   2    2    5	   hostess
 WTFB  WTPS  ATDS  ATDS  ATDS  ATDS  ATDS  INQE  INQE  INFL  INFL  INFL  GTAP  GTAP  GTAP  GTAP  GTAP  GTAP  GTAP  GTAP  GTAP  GTAP  GTAP   2    3    5	   passenger

 Flight 2: passenger 6 checked
 WTFB  CKPS  ATDS  ATDS  ATDS  ATDS  ATDS  INQE  INQE  INFL  INFL  INFL  GTAP  GTAP  GTAP  GTAP  GTAP  GTAP  GTAP  GTAP  GTAP  GTAP  GTAP   1    3    5	   hostess
 WTFB  CKPS  ATDS  ATDS  ATDS  ATDS  ATDS  INQE  INFL  INFL  INFL  INFL  GTAP  GTAP  GTAP  GTAP  GTAP  GTAP  GTAP  GTAP  GTAP  GTAP  GTAP   1    4    5	   passenger
 WTFB  WTPS  ATDS  ATDS  ATDS  ATDS  ATDS  INQE  INFL  INFL  INFL  INFL  GTAP  GTAP  GTAP  GTAP  GTAP  GTAP  GTAP  GTAP  GTAP  GTAP  GTAP   1    4    5	   hostess

 Flight 2: passenger 5 checked
 WTFB  CKPS  ATDS  ATDS  ATDS  ATDS  ATDS  INQE  INFL  INFL  INFL  INFL  GTAP  GTAP  GTAP  GTAP  GTAP  GTAP  GTAP  GTAP  GTAP  GTAP  GTAP   0    4    5	   hostess
 WTFB  CKPS  ATDS  ATDS  ATDS  ATDS  ATDS  INFL  INFL  INFL  INFL  INFL  GTAP  GTAP  GTAP  GTAP  GTAP  GTAP  GTAP  GTAP  GTAP  GTAP  GTAP   0    5    5	   passenger
 WTFB  WTPS  ATDS  ATDS  ATDS  ATDS  ATDS  INFL  INFL  INFL  INFL  INFL  GTAP  GTAP  GTAP  GTAP  GTAP  GTAP  GTAP  GTAP  GTAP  GTAP  GTAP   0    5    5	   hostess
 WTFB  RDTF  ATDS  ATDS  ATDS  ATDS  ATDS  INFL  INFL  INFL  INFL  INFL  GTAP  GTAP  GTAP  GTAP  GTAP  GTAP  GTAP  GTAP  GTAP  GTAP  GTAP   0    5    5	   hostess
 WTFB  WTFL  ATDS  ATDS  ATDS  ATDS  ATDS  INFL  INFL  INFL  INFL  INFL  GTAP  GTAP  GTAP  GTAP  GTAP  GTAP  GTAP  GTAP  GTAP  GTAP  GTAP   0    5    5	   hostess

 Flight 2: departed with 5 passengers
 FLFW  WTFL  ATDS  ATDS  ATDS  ATDS  ATDS  INFL  INFL  INFL  INFL  INFL  GTAP  GTAP  GTAP  GTAP  GTAP  GTAP  GTAP  GTAP  GTAP  GTAP  GTAP   0    5    5	   pilot

 Flight 2: departed with 5 passengers
 FLFW  WTFL  ATDS  ATDS  ATDS  ATDS  ATDS  INFL  INFL  INFL  INFL  INFL  GTAP  GTAP  GTAP  GTAP  GTAP  GTAP  INQE  GTAP  GTAP  GTAP  GTAP   1    5    5	   passenger

 Flight 2: flight arrived
 DRPP  WTFL  ATDS  ATDS  ATDS  ATDS  ATDS  INFL  INFL  INFL  INFL  INFL  GTAP  GTAP  GTAP  GTAP  GTAP  GTAP  INQE  GTAP  GTAP  GTAP  GTAP   1    5    5	   pilot
 DRPP  WTFL  ATDS  ATDS  ATDS  ATDS  ATDS  INFL  INFL  INFL  INFL  INFL  GTAP  GTAP  GTAP  GTAP  GTAP  GTAP  INQE  GTAP  INQE  GTAP  GTAP   2    5    5	   passenger
 DRPP  WTFL  ATDS  ATDS  ATDS  ATDS  ATDS  INFL  INFL  INFL  INFL  INFL  GTAP  GTAP  GTAP  GTAP  GTAP  GTAP  INQE  INQE  INQE  GTAP  GTAP   3    5    5	   passenger
 DRPP  WTFL  ATDS  ATDS  ATDS  ATDS  ATDS  INFL  INFL  INFL  INFL  INFL  GTAP  GTAP  GTAP  GTAP  GTAP  GTAP  INQE  INQE  INQE  INQE  GTAP   4    5    5	   passenger
 DRPP  WTFL  ATDS  ATDS  ATDS  ATDS  ATDS  INFL  ATDS  INFL  INFL  INFL  GTAP  GTAP  GTAP  GTAP  GTAP  GTAP  INQE  INQE  INQE  INQE  GTAP   4    4    6	   passenger

 Flight 2: returning
 FLBK  WTFL  ATDS  ATDS  ATDS  ATDS  ATDS  INFL  ATDS  INFL  INFL  INFL  GTAP  GTAP  GTAP  GTAP  GTAP  GTAP  INQE  INQE  INQE  INQE  GTAP   4    4    6	   pilot
 FLBK  WTFL  ATDS  ATDS  ATDS  ATDS  ATDS  INFL  ATDS  ATDS  INFL  INFL  GTAP  GTAP  GTAP  GTAP  GTAP  GTAP  INQE  INQE  INQE  INQE  GTAP   4    3    7	   passenger
 FLBK  WTFL  ATDS  ATDS  ATDS  ATDS  ATDS  INFL  ATDS  ATDS  INFL  INFL  GTAP  GTAP  GTAP  GTAP  GTAP  INQE  INQE  INQE  INQE  INQE  GTAP   5    3    7	   passenger
 FLBK  WTFL  ATDS  ATDS  ATDS  ATDS  ATDS  INFL  ATDS  ATDS  ATDS  INFL  GTAP  GTAP  GTAP  GTAP  GTAP  INQE  INQE  INQE  INQE  INQE  GTAP   5    2    8	   passenger
 ATRG  WTFL  ATDS  ATDS  ATDS  ATDS  ATDS  INFL  ATDS  ATDS  ATDS  INFL  GTAP  GTAP  GTAP  GTAP  GTAP  INQE  INQE  INQE  INQE  INQE  GTAP   5    2    8	   pilot
 ATRG  WTFL  ATDS  ATDS  ATDS  ATDS  ATDS  INFL  ATDS  ATDS  ATDS  INFL  GTAP  INQE  GTAP  GTAP  GTAP  INQE  INQE  INQE  INQE  INQE  GTAP   6    2    8	   passenger
 ATRG  WTFL  ATDS  ATDS  ATDS  ATDS  ATDS  INFL  ATDS  ATDS  ATDS  ATDS  GTAP  INQE  GTAP  GTAP  GTAP  INQE  INQE  INQE  INQE  INQE  GTAP   6    1    9	   passenger
 ATRG  WTFL  ATDS  ATDS  ATDS  ATDS  ATDS  INFL  ATDS  ATDS  ATDS  ATDS  GTAP  INQE  GTAP  GTAP  INQE  INQE  INQE  INQE  INQE  INQE  GTAP   7    1    9	   passenger
 ATRG  WTFL  ATDS  ATDS  ATDS  ATDS  ATDS  ATDS  ATDS  ATDS  ATDS  ATDS  GTAP  INQE  GTAP  GTAP  INQE  INQE  INQE  INQE  INQE  INQE  GTAP   7    0    10	   passenger
 ATRG  WTFL  ATDS  ATDS  ATDS  ATDS  ATDS  ATDS  ATDS  ATDS  ATDS  ATDS  GTAP  INQE  GTAP  INQE  INQE  INQE  INQE  INQE  INQE  INQE  GTAP   8    0    10	   passenger
 ATRG  WTFL  ATDS  ATDS  ATDS  ATDS  ATDS  ATDS  ATDS  ATDS  ATDS  ATDS  GTAP  INQE  INQE  INQE  INQE  INQE  INQE  INQE  INQE  INQE  GTAP   9    0    10	   passenger
 ATRG  WTFL  ATDS  ATDS  ATDS  ATDS  ATDS  ATDS  ATDS  ATDS  ATDS  ATDS  INQE  INQE  INQE  INQE  INQE  INQE  INQE  INQE  INQE  INQE  GTAP   10    0    10	   passenger

 Flight 3: boarding started
 RDFB  WTFL  ATDS  ATDS  ATDS  ATDS  ATDS  ATDS  ATDS  ATDS  ATDS  ATDS  INQE  INQE  INQE  INQE  INQE  INQE  INQE  INQE  INQE  INQE  GTAP   10    0    10	   pilot
 WTFB  WTFL  ATDS  ATDS  ATDS  ATDS  ATDS  ATDS  ATDS  ATDS  ATDS  ATDS  INQE  INQE  INQE  INQE  INQE  INQE  INQE  INQE  INQE  INQE  GTAP   10    0    10	   pilot
 WTFB  WTPS  ATDS  ATDS  ATDS  ATDS  ATDS  ATDS  ATDS  ATDS  ATDS  ATDS  INQE  INQE  INQE  INQE  INQE  INQE  INQE  INQE  INQE  INQE  GTAP   10    0    10	   hostess
 WTFB  WTPS  ATDS  ATDS  ATDS  ATDS  ATDS  ATDS  ATDS  ATDS  ATDS  ATDS  INQE  INQE  INQE  INQE  INQE  INQE  INQE  INQE  INQE  INQE  GTAP   10    0    10	   hostess

 Flight 3: passenger 16 checked
 WTFB  CKPS  ATDS  ATDS  ATDS  ATDS  ATDS  ATDS  ATDS  ATDS  ATDS  ATDS  INQE  INQE  INQE  INQE  INQE  INQE  INQE  INQE  INQE  INQE  GTAP   9    0    10	   hostess
 WTFB  WTPS  ATDS  ATDS  ATDS  ATDS  ATDS  ATDS  ATDS  ATDS  ATDS  ATDS  INQE  INQE  INQE  INQE  INQE  INQE  INQE  INQE  INQE  INQE  GTAP   9    0    10	   hostess

 Flight 3: passenger 18 checked
 WTFB  CKPS  ATDS  ATDS  ATDS  ATDS  ATDS  ATDS  ATDS  ATDS  ATDS  ATDS  INQE  INQE  INQE  INQE  INQE  INQE  INQE  INQE  INQE  INQE  GTAP   8    0    10	   hostess
 WTFB  CKPS  ATDS  ATDS  ATDS  ATDS  ATDS  ATDS  ATDS  ATDS  ATDS  ATDS  INQE  INQE  INQE  INQE  INQE  INQE  INFL  INQE  INQE  INQE  GTAP   8    1    10	   passenger
 WTFB  WTPS  ATDS  ATDS  ATDS  ATDS  ATDS  ATDS  ATDS  ATDS  ATDS  ATDS  INQE  INQE  INQE  INQE  INQE  INQE  INFL  INQE  INQE  INQE  GTAP   8    1    10	   hostess
 WTFB  WTPS  ATDS  ATDS  ATDS  ATDS  ATDS  ATDS  ATDS  ATDS  ATDS  ATDS  INQE  INQE  INQE  INQE  INQE  INQE  INFL  INQE  INFL  INQE  GTAP   8    2    10	   passenger

 Flight 3: passenger 17 checked
 WTFB  CKPS  ATDS  ATDS  ATDS  ATDS  ATDS  ATDS  ATDS  ATDS  ATDS  ATDS  INQE  INQE  INQE  INQE  INQE  INQE  INFL  INQE  INFL  INQE  GTAP   7    2    10	   hostess
 WTFB  CKPS  ATDS  ATDS  ATDS  ATDS  ATDS  ATDS  ATDS  ATDS  ATDS  ATDS  INQE  INQE  INQE  INQE  INQE  INQE  INFL  INFL  INFL  INQE  GTAP   7    3    10	   passenger
 WTFB  WTPS  ATDS  ATDS  ATDS  ATDS  ATDS  ATDS  ATDS  ATDS  ATDS  ATDS  INQE  INQE  INQE  INQE  INQE  INQE  INFL  INFL  INFL  INQE  GTAP   7    3    10	   hostess

 Flight 3: passenger 19 checked
 WTFB  CKPS  ATDS  ATDS  ATDS  ATDS  ATDS  ATDS  ATDS  ATDS  ATDS  ATDS  INQE  INQE  INQE  INQE  INQE  INQE  INFL  INFL  INFL  INQE  GTAP   6    3    10	   hostess
 WTFB  CKPS  ATDS  ATDS  ATDS  ATDS  ATDS  ATDS  ATDS  ATDS  ATDS  ATDS  INQE  INQE  INQE  INQE  INQE  INQE  INFL  INFL  INFL  INFL  GTAP   6    4    10	   passenger
 WTFB  WTPS  ATDS  ATDS  ATDS  ATDS  ATDS  ATDS  ATDS  ATDS  ATDS  ATDS  INQE  INQE  INQE  INQE  INQE  INQE  INFL  INFL  INFL  INFL  GTAP   6    4    10	   hostess

 Flight 3: passenger 15 checked
 WTFB  CKPS  ATDS  ATDS  ATDS  ATDS  ATDS  ATDS  ATDS  ATDS  ATDS  ATDS  INQE  INQE  INQE  INQE  INQE  INQE  INFL  INFL  INFL  INFL  GTAP   5    4    10	   hostess
 WTFB  WTPS  ATDS  ATDS  ATDS  ATDS  ATDS  ATDS  ATDS  ATDS  ATDS  ATDS  INQE  INQE  INQE  INQE  INQE  INQE  INFL  INFL  INFL  INFL  GTAP   5    4    10	   hostess
 WTFB  WTPS  ATDS  ATDS  ATDS  ATDS  ATDS  ATDS  ATDS  ATDS  ATDS  ATDS  INQE  INQE  INQE  INQE  INQE  INFL  INFL  INFL  INFL  INFL  GTAP   5    5    10	   passenger

 Flight 3: passenger 11 checked
 WTFB  CKPS  ATDS  ATDS  ATDS  ATDS  ATDS  ATDS  ATDS  ATDS  ATDS  ATDS  INQE  INQE  INQE  INQE  INQE  INFL  INFL  INFL  INFL  INFL  GTAP   4    5    10	   hostess
 WTFB  WTPS  ATDS  ATDS  ATDS  ATDS  ATDS  ATDS  ATDS  ATDS  ATDS  ATDS  INQE  INQE  INQE  INQE  INQE  INFL  INFL  INFL  INFL  INFL  GTAP   4    5    10	   hostess
 WTFB  WTPS  ATDS  ATDS  ATDS  ATDS  ATDS  ATDS  ATDS  ATDS  ATDS  ATDS  INQE  INFL  INQE  INQE  INQE  INFL  INFL  INFL  INFL  INFL  GTAP   4    6    10	   passenger

 Flight 3: passenger 14 checked
 WTFB  CKPS  ATDS  ATDS  ATDS  ATDS  ATDS  ATDS  ATDS  ATDS  ATDS  ATDS  INQE  INFL  INQE  INQE  INQE  INFL  INFL  INFL  INFL  INFL  GTAP   3    6    10	   hostess
 WTFB  CKPS  ATDS  ATDS  ATDS  ATDS  ATDS  ATDS  ATDS  ATDS  ATDS  ATDS  INQE  INFL  INQE  INQE  INFL  INFL  INFL  INFL  INFL  INFL  GTAP   3    7    10	   passenger
 WTFB  WTPS  ATDS  ATDS  ATDS  ATDS  ATDS  ATDS  ATDS  ATDS  ATDS  ATDS  INQE  INFL  INQE  INQE  INFL  INFL  INFL  INFL  INFL  INFL  GTAP   3    7    10	   hostess

 Flight 3: passenger 13 checked
 WTFB  CKPS  ATDS  ATDS  ATDS  ATDS  ATDS  ATDS  ATDS  ATDS  ATDS  ATDS  INQE  INFL  INQE  INQE  INFL  INFL  INFL  INFL  INFL  INFL  GTAP   2    7    10	   hostess
 WTFB  CKPS  ATDS  ATDS  ATDS  ATDS  ATDS  ATDS  ATDS  ATDS  ATDS  ATDS  INQE  INFL  INQE  INFL  INFL  INFL  INFL  INFL  INFL  INFL  GTAP   2    8    10	   passenger
 WTFB  WTPS  ATDS  ATDS  ATDS  ATDS  ATDS  ATDS  ATDS  ATDS  ATDS  ATDS  INQE  INFL  INQE  INFL  INFL  INFL  INFL  INFL  INFL  INFL  GTAP   2    8    10	   hostess

 Flight 3: passenger 12 checked
 WTFB  CKPS  ATDS  ATDS  ATDS  ATDS  ATDS  ATDS  ATDS  ATDS  ATDS  ATDS  INQE  INFL  INQE  INFL  INFL  INFL  INFL  INFL  INFL  INFL  GTAP   1    8    10	   hostess
 WTFB  CKPS  ATDS  ATDS  ATDS  ATDS  ATDS  ATDS  ATDS  ATDS  ATDS  ATDS  INQE  INFL  INFL  INFL  INFL  INFL  INFL  INFL  INFL  INFL  GTAP   1    9    10	   passenger
 WTFB  WTPS  ATDS  ATDS  ATDS  ATDS  ATDS  ATDS  ATDS  ATDS  ATDS  ATDS  INQE  INFL  INFL  INFL  INFL  INFL  INFL  INFL  INFL  INFL  GTAP   1    9    10	   hostess

 Flight 3: passenger 10 checked
 WTFB  CKPS  ATDS  ATDS  ATDS  ATDS  ATDS  ATDS  ATDS  ATDS  ATDS  ATDS  INQE  INFL  INFL  INFL  INFL  INFL  INFL  INFL  INFL  INFL  GTAP   0    9    10	   hostess
 WTFB  WTPS  ATDS  ATDS  ATDS  ATDS  ATDS  ATDS  ATDS  ATDS  ATDS  ATDS  INQE  INFL  INFL  INFL  INFL  INFL  INFL  INFL  INFL  INFL  GTAP   0    9    10	   hostess
 WTFB  WTPS  ATDS  ATDS  ATDS  ATDS  ATDS  ATDS  ATDS  ATDS  ATDS  ATDS  INFL  INFL  INFL  INFL  INFL  INFL  INFL  INFL  INFL  INFL  GTAP   0    10    10	   passenger
 WTFB  RDTF  ATDS  ATDS  ATDS  ATDS  ATDS  ATDS  ATDS  ATDS  ATDS  ATDS  INFL  INFL  INFL  INFL  INFL  INFL  INFL  INFL  INFL  INFL  GTAP   0    10    10	   hostess
 WTFB  WTFL  ATDS  ATDS  ATDS  ATDS  ATDS  ATDS  ATDS  ATDS  ATDS  ATDS  INFL  INFL  INFL  INFL  INFL  INFL  INFL  INFL  INFL  INFL  GTAP   0    10    10	   hostess

 Flight 3: departed with 10 passengers
 FLFW  WTFL  ATDS  ATDS  ATDS  ATDS  ATDS  ATDS  ATDS  ATDS  ATDS  ATDS  INFL  INFL  INFL  INFL  INFL  INFL  INFL  INFL  INFL  INFL  GTAP   0    10    10	   pilot

 Flight 3: departed with 10 passengers
 FLFW  WTFL  ATDS  ATDS  ATDS  ATDS  ATDS  ATDS  ATDS  ATDS  ATDS  ATDS  INFL  INFL  INFL  INFL  INFL  INFL  INFL  INFL  INFL  INFL  INQE   1    10    10	   passenger

 Flight 3: flight arrived
 DRPP  WTFL  ATDS  ATDS  ATDS  ATDS  ATDS  ATDS  ATDS  ATDS  ATDS  ATDS  INFL  INFL  INFL  INFL  INFL  INFL  INFL  INFL  INFL  INFL  INQE   1    10    10	   pilot
 DRPP  WTFL  ATDS  ATDS  ATDS  ATDS  ATDS  ATDS  ATDS  ATDS  ATDS  ATDS  INFL  INFL  INFL  INFL  INFL  INFL  ATDS  INFL  INFL  INFL  INQE   1    9    11	   passenger

 Flight 3: returning
 FLBK  WTFL  ATDS  ATDS  ATDS  ATDS  ATDS  ATDS  ATDS  ATDS  ATDS  ATDS  INFL  INFL  INFL  INFL  INFL  INFL  ATDS  INFL  INFL  INFL  INQE   1    9    11	   pilot
 FLBK  WTFL  ATDS  ATDS  ATDS  ATDS  ATDS  ATDS  ATDS  ATDS  ATDS  ATDS  INFL  ATDS  INFL  INFL  INFL  INFL  ATDS  INFL  INFL  INFL  INQE   1    8    12	   passenger
 FLBK  WTFL  ATDS  ATDS  ATDS  ATDS  ATDS  ATDS  ATDS  ATDS  ATDS  ATDS  INFL  ATDS  ATDS  INFL  INFL  INFL  ATDS  INFL  INFL  INFL  INQE   1    7    13	   passenger
 FLBK  WTFL  ATDS  ATDS  ATDS  ATDS  ATDS  ATDS  ATDS  ATDS  ATDS  ATDS  ATDS  ATDS  ATDS  INFL  INFL  INFL  ATDS  INFL  INFL  INFL  INQE   1    6    14	   passenger
 FLBK  WTFL  ATDS  ATDS  ATDS  ATDS  ATDS  ATDS  ATDS  ATDS  ATDS  ATDS  ATDS  ATDS  ATDS  ATDS  INFL  INFL  ATDS  INFL  INFL  INFL  INQE   1    5    15	   passenger
 ATRG  WTFL  ATDS  ATDS  ATDS  ATDS  ATDS  ATDS  ATDS  ATDS  ATDS  ATDS  ATDS  ATDS  ATDS  ATDS  INFL  INFL  ATDS  INFL  INFL  INFL  INQE   1    5    15	   pilot
 ATRG  WTFL  ATDS  ATDS  ATDS  ATDS  ATDS  ATDS  ATDS  ATDS  ATDS  ATDS  ATDS  ATDS  ATDS  ATDS  INFL  INFL  ATDS  INFL  INFL  ATDS  INQE   1    4    16	   passenger
 ATRG  WTFL  ATDS  ATDS  ATDS  ATDS  ATDS  ATDS  ATDS  ATDS  ATDS  ATDS  ATDS  ATDS  ATDS  ATDS  INFL  INFL  ATDS  INFL  ATDS  ATDS  INQE   1    3    17	   passenger

 Flight 4: boarding started
 RDFB  WTFL  ATDS  ATDS  ATDS  ATDS  ATDS  ATDS  ATDS  ATDS  ATDS  ATDS  ATDS  ATDS  ATDS  ATDS  INFL  INFL  ATDS  INFL  ATDS  ATDS  INQE   1    3    17	   pilot

 Flight 5: boarding started
 RDFB  WTFL  ATDS  ATDS  ATDS  ATDS  ATDS  ATDS  ATDS  ATDS  ATDS  ATDS  ATDS  ATDS  ATDS  ATDS  INFL  ATDS  ATDS  INFL  ATDS  ATDS  INQE   1    2    18	   passenger
 WTFB  WTFL  ATDS  ATDS  ATDS  ATDS  ATDS  ATDS  ATDS  ATDS  ATDS  ATDS  ATDS  ATDS  ATDS  ATDS  INFL  ATDS  ATDS  INFL  ATDS  ATDS  INQE   1    2    18	   pilot
 WTFB  WTFL  ATDS  ATDS  ATDS  ATDS  ATDS  ATDS  ATDS  ATDS  ATDS  ATDS  ATDS  ATDS  ATDS  ATDS  INFL  ATDS  ATDS  ATDS  ATDS  ATDS  INQE   1    1    19	   passenger
 WTFB  WTPS  ATDS  ATDS  ATDS  ATDS  ATDS  ATDS  ATDS  ATDS  ATDS  ATDS  ATDS  ATDS  ATDS  ATDS  INFL  ATDS  ATDS  ATDS  ATDS  ATDS  INQE   1    1    19	   hostess
 WTFB  WTPS  ATDS  ATDS  ATDS  ATDS  ATDS  ATDS  ATDS  ATDS  ATDS  ATDS  ATDS  ATDS  ATDS  ATDS  ATDS  ATDS  ATDS  ATDS  ATDS  ATDS  INQE   1    0    20	   passenger
 WTFB  WTPS  ATDS  ATDS  ATDS  ATDS  ATDS  ATDS  ATDS  ATDS  ATDS  ATDS  ATDS  ATDS  ATDS  ATDS  ATDS  ATDS  ATDS  ATDS  ATDS  ATDS  INQE   1    0    20	   hostess

 Flight 5: passenger 20 checked
 WTFB  CKPS  ATDS  ATDS  ATDS  ATDS  ATDS  ATDS  ATDS  ATDS  ATDS  ATDS  ATDS  ATDS  ATDS  ATDS  ATDS  ATDS  ATDS  ATDS  ATDS  ATDS  INQE   0    0    20	   hostess
 WTFB  CKPS  ATDS  ATDS  ATDS  ATDS  ATDS  ATDS  ATDS  ATDS  ATDS  ATDS  ATDS  ATDS  ATDS  ATDS  ATDS  ATDS  ATDS  ATDS  ATDS  ATDS  INFL   0    1    20	   passenger
 WTFB  WTPS  ATDS  ATDS  ATDS  ATDS  ATDS  ATDS  ATDS  ATDS  ATDS  ATDS  ATDS  ATDS  ATDS  ATDS  ATDS  ATDS  ATDS  ATDS  ATDS  ATDS  INFL   0    1    20	   hostess
 WTFB  RDTF  ATDS  ATDS  ATDS  ATDS  ATDS  ATDS  ATDS  ATDS  ATDS  ATDS  ATDS  ATDS  ATDS  ATDS  ATDS  ATDS  ATDS  ATDS  ATDS  ATDS  INFL   0    1    20	   hostess
 WTFB  WTFL  ATDS  ATDS  ATDS  ATDS  ATDS  ATDS  ATDS  ATDS  ATDS  ATDS  ATDS  ATDS  ATDS  ATDS  ATDS  ATDS  ATDS  ATDS  ATDS  ATDS  INFL   0    1    20	   hostess

 Flight 5: departed with 1 passengers
 FLFW  WTFL  ATDS  ATDS  ATDS  ATDS  ATDS  ATDS  ATDS  ATDS  ATDS  ATDS  ATDS  ATDS  ATDS  ATDS  ATDS  ATDS  ATDS  ATDS  ATDS  ATDS  INFL   0    1    20	   pilot

 Flight 5: flight arrived
 DRPP  WTFL  ATDS  ATDS  ATDS  ATDS  ATDS  ATDS  ATDS  ATDS  ATDS  ATDS  ATDS  ATDS  ATDS  ATDS  ATDS  ATDS  ATDS  ATDS  ATDS  ATDS  INFL   0    1    20	   pilot
 DRPP  WTFL  ATDS  ATDS  ATDS  ATDS  ATDS  ATDS  ATDS  ATDS  ATDS  ATDS  ATDS  ATDS  ATDS  ATDS  ATDS  ATDS  ATDS  ATDS  ATDS  ATDS  ATDS   0    0    21	   passenger

 Flight 5: returning
 FLBK  WTFL  ATDS  ATDS  ATDS  ATDS  ATDS  ATDS  ATDS  ATDS  ATDS  ATDS  ATDS  ATDS  ATDS  ATDS  ATDS  ATDS  ATDS  ATDS  ATDS  ATDS  ATDS   0    0    21	   pilot
 ATRG  WTFL  ATDS  ATDS  ATDS  ATDS  ATDS  ATDS  ATDS  ATDS  ATDS  ATDS  ATDS  ATDS  ATDS  ATDS  ATDS  ATDS  ATDS  ATDS  ATDS  ATDS  ATDS   0    0    21	   pilot
