                Airlift - Description of internal state
  PT    HT   P00   P01   P02   P03   P04   P05   P06   P07   P08   P09   P10   P11   P12   P13   P14   P15   P16   P17   P18   P19   P20   InQ  InF  PTAL  Entity
 ATRG  WTFL  GTAP  GTAP  GTAP  GTAP  GTAP  GTAP  GTAP  GTAP  GTAP  GTAP  GTAP  GTAP  GTAP  GTAP  GTAP  GTAP  GTAP  GTAP  GTAP  GTAP  GTAP   0    0    0	   header

 Flight 1: boarding started
 RDFB  WTFL  GTAP  GTAP  GTAP  GTAP  GTAP  GTAP  GTAP  GTAP  GTAP  GTAP  GTAP  GTAP  GTAP  GTAP  GTAP  GTAP  GTAP  GTAP  GTAP  GTAP  GTAP   0    0    0	   pilot
 WTFB  WTFL  GTAP  GTAP  GTAP  GTAP  GTAP  GTAP  GTAP  GTAP  GTAP  GTAP  GTAP  GTAP  GTAP  GTAP  GTAP  GTAP  GTAP  GTAP  GTAP  GTAP  GTAP   0    0    0	   pilot
 WTFB  WTPS  GTAP  GTAP  GTAP  GTAP  GTAP  GTAP  GTAP  GTAP  GTAP  GTAP  GTAP  GTAP  GTAP  GTAP  GTAP  GTAP  GTAP  GTAP  GTAP  GTAP  GTAP   0    0    0	   hostess
 WTFB  WTPS  GTAP  GTAP  GTAP  GTAP  GTAP  GTAP  GTAP  GTAP  GTAP  GTAP  GTAP  GTAP  GTAP  GTAP  GTAP  GTAP  GTAP  GTAP  GTAP  GTAP  GTAP   0    0    0	   hostess
 WTFB  WTPS  GTAP  GTAP  GTAP  GTAP  INQE  GTAP  GTAP  GTAP  GTAP  GTAP  GTAP  GTAP  GTAP  GTAP  GTAP  GTAP  GTAP  GTAP  GTAP  GTAP  GTAP   1    0    0	   passenger

 Flight 1: passenger 4 checked
 WTFB  CKPS  GTAP  GTAP  GTAP  GTAP  INQE  GTAP  GTAP  GTAP  GTAP  GTAP  GTAP  GTAP  GTAP  GTAP  GTAP  GTAP  GTAP  GTAP  GTAP  GTAP  GTAP   0    0    0	   hostess
 WTFB  CKPS  GTAP  INQE  GTAP  GTAP  INQE  GTAP  GTAP  GTAP  GTAP  GTAP  GTAP  GTAP  GTAP  GTAP  GTAP  GTAP  GTAP  GTAP  GTAP  GTAP  GTAP   1    0    0	   passenger
 WTFB  CKPS  INQE  INQE  GTAP  GTAP  INQE  GTAP  GTAP  GTAP  GTAP  GTAP  GTAP  GTAP  GTAP  GTAP  GTAP  GTAP  GTAP  GTAP  GTAP  GTAP  GTAP   2    0    0	   passenger
 WTFB  CKPS  INQE  INQE  GTAP  INQE  INQE  GTAP  GTAP  GTAP  GTAP  GTAP  GTAP  GTAP  GTAP  GTAP  GTAP  GTAP  GTAP  GTAP  GTAP  GTAP  GTAP   3    0    0	   passenger
 WTFB  CKPS  INQE  INQE  INQE  INQE  INQE  GTAP  GTAP  GTAP  GTAP  GTAP  GTAP  GTAP  GTAP  GTAP  GTAP  GTAP  GTAP  GTAP  GTAP  GTAP  GTAP   4    0    0	   passenger
 WTFB  WTPS  INQE  INQE  INQE  INQE  INQE  GTAP  GTAP  GTAP  GTAP  GTAP  GTAP  GTAP  GTAP  GTAP  GTAP  GTAP  GTAP  GTAP  GTAP  GTAP  GTAP   4    0    0	   hostess

 Flight 1: passenger 1 checked
 WTFB  CKPS  INQE  INQE  INQE  INQE  INQE  GTAP  GTAP  GTAP  GTAP  GTAP  GTAP  GTAP  GTAP  GTAP  GTAP  GTAP  GTAP  GTAP  GTAP  GTAP  GTAP   3    0    0	   hostess
 WTFB  WTPS  INQE  INQE  INQE  INQE  INQE  GTAP  GTAP  GTAP  GTAP  GTAP  GTAP  GTAP  GTAP  GTAP  GTAP  GTAP  GTAP  GTAP  GTAP  GTAP  GTAP   3    0    0	   hostess

 Flight 1: passenger 0 checked
 WTFB  CKPS  INQE  INQE  INQE  INQE  INQE  GTAP  GTAP  GTAP  GTAP  GTAP  GTAP  GTAP  GTAP  GTAP  GTAP  GTAP  GTAP  GTAP  GTAP  GTAP  GTAP   2    0    0	   hostess
 WTFB  WTPS  INQE  INQE  INQE  INQE  INQE  GTAP  GTAP  GTAP  GTAP  GTAP  GTAP  GTAP  GTAP  GTAP  GTAP  GTAP  GTAP  GTAP  GTAP  GTAP  GTAP   2    0    0	   hostess

 Flight 1: passenger 3 checked
 WTFB  CKPS  INQE  INQE  INQE  INQE  INQE  GTAP  GTAP  GTAP  GTAP  GTAP  GTAP  GTAP  GTAP  GTAP  GTAP  GTAP  GTAP  GTAP  GTAP  GTAP  GTAP   1    0    0	   hostess
 WTFB  WTPS  INQE  INQE  INQE  INQE  INQE  GTAP  GTAP  GTAP  GTAP  GTAP  GTAP  GTAP  GTAP  GTAP  GTAP  GTAP  GTAP  GTAP  GTAP  GTAP  GTAP   1    0    0	   hostess

 Flight 1: passenger 2 checked
 WTFB  CKPS  INQE  INQE  INQE  INQE  INQE  GTAP  GTAP  GTAP  GTAP  GTAP  GTAP  GTAP  GTAP  GTAP  GTAP  GTAP  GTAP  GTAP  GTAP  GTAP  GTAP   0    0    0	   hostess
 WTFB  WTPS  INQE  INQE  INQE  INQE  INQE  GTAP  GTAP  GTAP  GTAP  GTAP  GTAP  GTAP  GTAP  GTAP  GTAP  GTAP  GTAP  GTAP  GTAP  GTAP  GTAP   0    0    0	   hostess
 WTFB  RDTF  INQE  INQE  INQE  INQE  INQE  GTAP  GTAP  GTAP  GTAP  GTAP  GTAP  GTAP  GTAP  GTAP  GTAP  GTAP  GTAP  GTAP  GTAP  GTAP  GTAP   0    0    0	   hostess
 WTFB  WTFL  INQE  INQE  INQE  INQE  INQE  GTAP  GTAP  GTAP  GTAP  GTAP  GTAP  GTAP  GTAP  GTAP  GTAP  GTAP  GTAP  GTAP  GTAP  GTAP  GTAP   0    0    0	   hostess
 WTFB  WTFL  INFL  INQE  INQE  INQE  INQE  GTAP  GTAP  GTAP  GTAP  GTAP  GTAP  GTAP  GTAP  GTAP  GTAP  GTAP  GTAP  GTAP  GTAP  GTAP  GTAP   0    1    0	   passenger
 WTFB  WTFL  INFL  INQE  INQE  INFL  INQE  GTAP  GTAP  GTAP  GTAP  GTAP  GTAP  GTAP  GTAP  GTAP  GTAP  GTAP  GTAP  GTAP  GTAP  GTAP  GTAP   0    2    0	   passenger
 WTFB  WTFL  INFL  INQE  INQE  INFL  INFL  GTAP  GTAP  GTAP  GTAP  GTAP  GTAP  GTAP  GTAP  GTAP  GTAP  GTAP  GTAP  GTAP  GTAP  GTAP  GTAP   0    3    0	   passenger
 WTFB  WTFL  INFL  INFL  INQE  INFL  INFL  GTAP  GTAP  GTAP  GTAP  GTAP  GTAP  GTAP  GTAP  GTAP  GTAP  GTAP  GTAP  GTAP  GTAP  GTAP  GTAP   0    4    0	   passenger
 WTFB  WTFL  INFL  INFL  INFL  INFL  INFL  GTAP  GTAP  GTAP  GTAP  GTAP  GTAP  GTAP  GTAP  GTAP  GTAP  GTAP  GTAP  GTAP  GTAP  GTAP  GTAP   0    5    0	   passenger
 WTFB  WTFL  INFL  INFL  INFL  INFL  INFL  INQE  GTAP  GTAP  GTAP  GTAP  GTAP  GTAP  GTAP  GTAP  GTAP  GTAP  GTAP  GTAP  GTAP  GTAP  GTAP   1    5    0	   passenger
 WTFB  WTFL  INFL  INFL  INFL  INFL  INFL  INQE  INQE  GTAP  GTAP  GTAP  GTAP  GTAP  GTAP  GTAP  GTAP  GTAP  GTAP  GTAP  GTAP  GTAP  GTAP   2    5    0	   passenger
 WTFB  WTFL  INFL  INFL  INFL  INFL  INFL  INQE  INQE  GTAP  GTAP  INQE  GTAP  GTAP  GTAP  GTAP  GTAP  GTAP  GTAP  GTAP  GTAP  GTAP  GTAP   3    5    0	   passenger
 WTFB  WTFL  INFL  INFL  INFL  INFL  INFL  INQE  INQE  INQE  GTAP  INQE  GTAP  GTAP  GTAP  GTAP  GTAP  GTAP  GTAP  GTAP  GTAP  GTAP  GTAP   4    5    0	   passenger
 WTFB  WTFL  INFL  INFL  INFL  INFL  INFL  INQE  INQE  INQE  INQE  INQE  GTAP  GTAP  GTAP  GTAP  GTAP  GTAP  GTAP  GTAP  GTAP  GTAP  GTAP   5    5    0	   passenger
 WTFB  WTFL  INFL  INFL  INFL  INFL  INFL  INQE  INQE  INQE  INQE  INQE  INQE  GTAP  GTAP  GTAP  GTAP  GTAP  GTAP  GTAP  GTAP  GTAP  GTAP   6    5    0	   passenger
 WTFB  WTFL  INFL  INFL  INFL  INFL  INFL  INQE  INQE  INQE  INQE  INQE  INQE  GTAP  GTAP  GTAP  INQE  GTAP  GTAP  GTAP  GTAP  GTAP  GTAP   7    5    0	   passenger
 WTFB  WTFL  INFL  INFL  INFL  INFL  INFL  INQE  INQE  INQE  INQE  INQE  INQE  GTAP  GTAP  INQE  INQE  GTAP  GTAP  GTAP  GTAP  GTAP  GTAP   8    5    0	   passenger
 WTFB  WTFL  INFL  INFL  INFL  INFL  INFL  INQE  INQE  INQE  INQE  INQE  INQE  GTAP  INQE  INQE  INQE  GTAP  GTAP  GTAP  GTAP  GTAP  GTAP   9    5    0	   passenger
 WTFB  WTFL  INFL  INFL  INFL  INFL  INFL  INQE  INQE  INQE  INQE  INQE  INQE  INQE  INQE  INQE  INQE  GTAP  GTAP  GTAP  GTAP  GTAP  GTAP   10    5    0	   passenger
 WTFB  WTFL  INFL  INFL  INFL  INFL  INFL  INQE  INQE  INQE  INQE  INQE  INQE  INQE  INQE  INQE  INQE  INQE  GTAP  GTAP  GTAP  GTAP  GTAP   11    5    0	   passenger
 WTFB  WTFL  INFL  INFL  INFL  INFL  INFL  INQE  INQE  INQE  INQE  INQE  INQE  INQE  INQE  INQE  INQE  INQE  INQE  GTAP  GTAP  GTAP  GTAP   12    5    0	   passenger
 WTFB  WTFL  INFL  INFL  INFL  INFL  INFL  INQE  INQE  INQE  INQE  INQE  INQE  INQE  INQE  INQE  INQE  INQE  INQE  GTAP  INQE  GTAP  GTAP   13    5    0	   passenger
 WTFB  WTFL  INFL  INFL  INFL  INFL  INFL  INQE  INQE  INQE  INQE  INQE  INQE  INQE  INQE  INQE  INQE  INQE  INQE  INQE  INQE  GTAP  GTAP   14    5    0	   passenger
 WTFB  WTFL  INFL  INFL  INFL  INFL  INFL  INQE  INQE  INQE  INQE  INQE  INQE  INQE  INQE  INQE  INQE  INQE  INQE  INQE  INQE  INQE  GTAP   15    5    0	   passenger
 WTFB  WTFL  INFL  INFL  INFL  INFL  INFL  INQE  INQE  INQE  INQE  INQE  INQE  INQE  INQE  INQE  INQE  INQE  INQE  INQE  INQE  INQE  INQE   16    5    0	   passenger
